# Class
DhcpClass	KEYWORD1
DNSClient	KEYWORD1
EthernetClass	KEYWORD1
HardwareSerial	KEYWORD1
Printable	KEYWORD1
Print	KEYWORD1
StringSumHelper	KEYWORD1
UDP	KEYWORD1

# Constants
DEG_TO_RAD	LITERAL1
EULER	LITERAL1
INADDR_NONE	LITERAL1
INPUT_PULLDOWN	LITERAL1
LOG_C	LITERAL1
LOG_D	LITERAL1
LOG_E	LITERAL1
LOG_I	LITERAL1
LOG_W	LITERAL1
NO_IGNORE_CHAR	LITERAL1
RAD_TO_DEG	LITERAL1
SERIAL_DEFAULT_CHANNEL	LITERAL1
SKIP_ALL	LITERAL1
SKIP_NONE	LITERAL1
SKIP_WHITESPACE	LITERAL1

# Function
analogWriteGetDefaultFreq	KEYWORD2
analogWriteSetDefaultFreq	KEYWORD2
analogWriteFreq	KEYWORD2
arrayForEach	KEYWORD2
arrayLength	KEYWORD2
beginMulticast	KEYWORD2
clearWriteError	KEYWORD2
clockCyclesPerMicrosecond	KEYWORD2
clockCyclesToMicroseconds	KEYWORD2
fromString	KEYWORD2
getTimeout	KEYWORD2
getWriteError	KEYWORD2
init	KEYWORD3
initVariant	KEYWORD3
ledOff	KEYWORD2
ledOn	KEYWORD2
makeWord	KEYWORD2
microsecondsToClockCycles	KEYWORD2
printTo	KEYWORD2
reserve	KEYWORD2
serialEvent	KEYWORD2
StringIfHelperType	KEYWORD2
toAscii	KEYWORD2
toDouble	KEYWORD2
toFloat	KEYWORD2
unuse	KEYWORD2
util_close_timer	KEYWORD2
util_get_time_collapsed	KEYWORD2
util_get_time_left	KEYWORD2
util_get_time_out	KEYWORD2
util_open_timer	KEYWORD2
util_start_timer	KEYWORD2
util_stop_timer	KEYWORD2
util_timer_is_running	KEYWORD2
attachTimerInterrupt	KEYWORD2
detachTimerInterrupt	KEYWORD2
