# Class
AudioClass	KEYWORD1
Audio	KEYWORD1

# Constants
WRITE_FIFO_FRAME_NUM	LITERAL1
WRITE_FIFO_FRAME_SIZE	LITERAL1
WRITE_BUF_SIZE	LITERAL1
READ_FIFO_FRAME_NUM	LITERAL1
READ_FIFO_FRAME_SIZE	LITERAL1
READ_BUF_SIZE	LITERAL1
FIFO_FRAME_SIZE	LITERAL1
SIMPLE_FIFO_BUF_SIZE	LITERAL1
CHUNKID_RIFF	LITERAL1
FORMAT_WAVE	LITERAL1
SUBCHUNKID_FMT	LITERAL1
SUBCHUNKID_DATA	LITERAL1
AUDIO_FORMAT_PCM	LITERAL1
FMT_SIZE	LITERAL1
AS_CODECTYPE_PCM	LITERAL1
AUDIOLIB_ECODE_OK	LITERAL1
AUDIOLIB_ECODE_SHARED_MEMORY_ERROR	LITERAL1
AUDIOLIB_ECODE_SIMPLEFIFO_ERROR	LITERAL1
AUDIOLIB_ECODE_AUDIOCOMMAND_ERROR	LITERAL1
AUDIOLIB_ECODE_FILEACCESS_ERROR	LITERAL1
AUDIOLIB_ECODE_FILEEND	LITERAL1
AUDIOLIB_ECODE_BUFFER_AREA_ERROR	LITERAL1
AUDIOLIB_ECODE_BUFFER_SIZE_ERROR	LITERAL1
AUDIOLIB_ECODE_INSUFFICIENT_BUFFER_AREA	LITERAL1
MEDIAPLAYER_ECODE_OK	LITERAL1
MEDIAPLAYER_ECODE_COMMAND_ERROR	LITERAL1
MEDIAPLAYER_ECODE_SIMPLEFIFO_ERROR	LITERAL1
MEDIAPLAYER_ECODE_FILEACCESS_ERROR	LITERAL1
MEDIAPLAYER_ECODE_FILEEND	LITERAL1
MEDIAPLAYER_ECODE_SHARED_MEMORY_ERROR	LITERAL1
MEDIAPLAYER_BUF_FRAME_NUM	LITERAL1
MEDIAPLAYER_BUF_FRAME_SIZE	LITERAL1
MEDIAPLAYER_BUF_SIZE	LITERAL1
MEDIARECORDER_ECODE_OK            LITERAL1
MEDIARECORDER_ECODE_COMMAND_ERROR LITERAL1
MEDIARECORDER_ECODE_BUFFER_INIT_ERROR LITERAL1
MEDIARECORDER_ECODE_BUFFER_POLL_ERROR LITERAL1
MEDIARECORDER_ECODE_DSP_ACCESS_ERROR LITERAL1
MEDIARECORDER_ECODE_FILEACCESS_ERROR LITERAL1
MEDIARECORDER_ECODE_BUFFER_SIZE_ERROR LITERAL1
MEDIARECORDER_ECODE_BUFFER_AREA_ERROR LITERAL1
MEDIARECORDER_ECODE_INSUFFICIENT_BUFFER_AREA LITERAL1
MEDIARECORDER_ECODE_BASEBAND_ERROR LITERAL1

# Function
outputDeviceCallback	KEYWORD2
print_err	KEYWORD2
print_dbg	KEYWORD2
setPlayerMode	KEYWORD2
setRecorderMode	KEYWORD2
setReadyMode	KEYWORD2
initPlayer	KEYWORD2
initRecorder	KEYWORD2
startPlayer	KEYWORD2
startRecorder	KEYWORD2
stopPlayer	KEYWORD2
stopRecorder	KEYWORD2
setBeep	KEYWORD2
setVolume	KEYWORD2
setLRgain	KEYWORD2
writeFrames	KEYWORD2
writeWavHeader	KEYWORD2
readFrames	KEYWORD2
closeOutputFile	KEYWORD2
objIf_createStaticPools	KEYWORD2
objIf_createMediaPlayer	KEYWORD2
objIf_createOutputMixer	KEYWORD2
objIf_activateMediaPlayer	KEYWORD2
objIf_activateOutputMixer	KEYWORD2
objIf_initMediaPlayer	KEYWORD2
objIf_startMediaPlayer	KEYWORD2
objIf_stopMediaPlayer	KEYWORD2
objIf_sendDataOutputMixer	KEYWORD2
objIf_reqNextMediaPlayerProcess	KEYWORD2
objIf_deactMediaPlayer	KEYWORD2
objIf_deactOutputMixer	KEYWORD2
objIf_activateBaseband	KEYWORD2
objIf_deactivateBaseband	KEYWORD2
getInstance	KEYWORD2
create	KEYWORD2
activate	KEYWORD2
reqNextProcess	KEYWORD2
deactivate	KEYWORD2
