# Class
SpGnss	KEYWORD1
SpGnssTime	KEYWORD1
SpSatellite	KEYWORD1
SpNavData	KEYWORD1

# Function
isSatelliteTypeGps	KEYWORD2
isSatelliteTypeGlonass	KEYWORD2
getSatelliteId	KEYWORD2
getSatelliteElevation	KEYWORD2
getSatelliteAzimuth	KEYWORD2
getSatelliteSignalLevel	KEYWORD2
start	KEYWORD2
isUpdate	KEYWORD2
waitUpdate	KEYWORD2
getNavData	KEYWORD2
getPositionDataSize	KEYWORD2
getPositionData	KEYWORD2
setPosition	KEYWORD2
setTime	KEYWORD2
setInterval	KEYWORD2
isGps	KEYWORD2
useGps	KEYWORD2
unuseGps	KEYWORD2
isGlonass	KEYWORD2
useGlonass	KEYWORD2
unuseGlonass	KEYWORD2
setDebugMode	KEYWORD2
saveEphemeris	KEYWORD2

# Value
year	KEYWORD3
month	KEYWORD3
day	KEYWORD3
hour	KEYWORD3
minute	KEYWORD3
sec	KEYWORD3
usec	KEYWORD3
type	KEYWORD3
svid	KEYWORD3
elevation	KEYWORD3
azimuth	KEYWORD3
sigLevel	KEYWORD3
numSatellites	KEYWORD3
posFixMode	KEYWORD3
posDataExist	KEYWORD3
numSatellitesCalcPos	KEYWORD3
satelliteType	KEYWORD3
posSatelliteType	KEYWORD3
latitude	KEYWORD3
longitude	KEYWORD3
altitude	KEYWORD3
velocity	KEYWORD3
pdop	KEYWORD3
hdop	KEYWORD3
vdop	KEYWORD3
tdop	KEYWORD3
satellite	KEYWORD3
